{
    "tiles": [
        [10, 11, 10, 10, 11, 10, 10, 11, 10, 10, 11,  0,  0,  0,  0,  0, 11, 10, 10, 11, 10, 10, 11, 10, 10, 11, 10, 10, 11, 10],
        [10, 11, 10, 10, 11, 10, 10, 11, 10, 10, 11,  0,  0,  0,  0,  0, 11, 10, 10, 11, 10, 10, 11, 10, 10, 11, 10, 10, 11, 10],
        [10, 11, 10, 10, 11, 10, 10, 11, 10, 10, 11,  0,  0,  0,  0,  0, 11, 10, 10, 11, 10, 10, 11, 10, 10, 11, 10, 10, 11, 10],
        [10, 11, 10, 10, 11, 10, 10, 11, 10, 10, 11,  0,  0,  0,  0,  0, 11, 10, 10, 11, 10, 10, 11, 10, 10, 11, 10, 10, 11, 10],
        [10, 11, 10, 10, 11, 10, 10, 11, 10, 10, 11,  0,  0,  0,  0,  0, 11, 10, 10, 11,  7,  7,  6,  7,  7,  6,  7,  7,  6,  7],
        [10, 11, 10, 10, 11, 10, 10, 11, 10, 10, 11,  0,  0,  0,  0,  0, 11,  7,  7,  6,  5,  0,  0,  0,  0,  0,  0,  0,  0,  0],
        [10, 11, 10, 10, 11, 10, 10, 11,  7,  7,  6,  0,  0,  0,  0,  0, 11,  0,  0,  0,  0,  0,  0,  0,  0,  0,  0,  0,  0,  0],
        [ 7,  6,  7,  7,  6,  7,  7,  6,  0,  0,  4,  0,  0,  0,  0,  0,  6,  0,  0,  0,  0,  0,  0,  0,  0,  0,  0,  0,  0,  0],
        [ 5,  0,  0,  0,  0,  5,  0,  0,  0,  0,  0,  0,  0,  0,  0,  0,  5,  0,  0,  0,  0,  0,  0,  0,  0,  0,  0,  0,  0,  0],
        [ 0,  0,  0,  0,  0,  0,  0,  0,  0,  0,  0,  0,  0,  0,  0,  0,  0,  0,  0,  0,  0,  0,  0,  0,  0,  0,  0,  0,  0,  0],
        [ 0,  0,  0,  0,  0,  0,  0,  0,  0,  0,  0,  0,  0,  0,  0,  0,  0,  0,  0,  0,  0,  0,  0,  2,  2,  1,  2,  2,  1,  2],
        [ 0,  0,  0,  0,  0,  0,  0,  0,  0,  0,  0,  0,  0,  0,  2,  2,  1,  0,  0,  0,  0,  0,  0, 10, 10, 11, 10, 10, 11, 10],
        [ 0,  0,  8,  0,  0,  0,  0,  0,  0,  0,  0,  0,  0,  0,  0,  0, 11,  0,  0,  0,  0,  0,  0, 10, 10, 11, 10, 10, 11, 10],
        [ 0,  0,  9,  0,  0,  0,  0,  0,  0,  0,  0,  0,  0,  0,  0,  0, 11,  0,  0,  0,  0,  0,  0, 10, 10, 11, 10, 10, 11, 10],
        [ 2,  1,  2,  2,  1,  2,  2,  1,  0,  0,  0,  0,  0,  3,  0,  0, 11,  0,  0,  0,  0,  0,  0, 10, 10, 11, 10, 10, 11, 10]
    ],
    "enemies": [
    ],
    "spawn": [4, 13]
}